3 2
0 0 2 rd
0 1 f ld
1 0 2 ru
1 1 4 uld
2 0 s ur
2 1 3 ul